"Standardized_name"	"Ecological_origins"	"Clades"	"origin"
"BFC"	"Fermentation"	"1. Wine/European"	"Domesticated"
"AGL"	"Wine"	"1. Wine/European"	"Domesticated"
"ABE"	"Human, clinical"	"1. Wine/European"	"Domesticated"
"SACE_YAM"	"Human, clinical"	"1. Wine/European"	"Domesticated"
"BKI"	"Wine"	"1. Wine/European"	"Domesticated"
"ABR"	"Soil"	"1. Wine/European"	"Domesticated"
"ABQ"	"Soil"	"1. Wine/European"	"Domesticated"
"BNV"	"Soil"	"1. Wine/European"	"Domesticated"
"BPB"	"Wine"	"1. Wine/European"	"Domesticated"
"BPT"	"Wine"	"1. Wine/European"	"Domesticated"
"BQM"	"Wine"	"1. Wine/European"	"Domesticated"
"BFK"	"Tree"	"1. Wine/European"	"Domesticated"
"BQS"	"Wine"	"1. Wine/European"	"Domesticated"
"BQE"	"Wine"	"1. Wine/European"	"Domesticated"
"AIN"	"Wine"	"1. Wine/European"	"Domesticated"
"BQR"	"Water"	"1. Wine/European"	"Domesticated"
"BLT"	"Wine"	"1. Wine/European"	"Domesticated"
"AIF"	"Wine"	"1. Wine/European"	"Domesticated"
"AQR"	"Wine"	"1. Wine/European"	"Domesticated"
"BPF"	"Fruit"	"1. Wine/European"	"Domesticated"
"BLR"	"Wine"	"1. Wine/European"	"Domesticated"
"BNL"	"Soil"	"1. Wine/European"	"Domesticated"
"BPK"	"Water"	"1. Wine/European"	"Domesticated"
"BKQ"	"Unknown"	"1. Wine/European"	"Domesticated"
"BPG"	"Unknown"	"1. Wine/European"	"Domesticated"
"BPH"	"Unknown"	"1. Wine/European"	"Domesticated"
"BQT"	"Wine"	"1. Wine/European"	"Domesticated"
"APT"	"Wine"	"1. Wine/European"	"Domesticated"
"BID"	"Bakery"	"1. Wine/European"	"Domesticated"
"AGI"	"Wine"	"1. Wine/European"	"Domesticated"
"BHV"	"Wine"	"1. Wine/European"	"Domesticated"
"BNE"	"Wine"	"1. Wine/European"	"Domesticated"
"BLA"	"Wine"	"1. Wine/European"	"Domesticated"
"BKT"	"Wine"	"1. Wine/European"	"Domesticated"
"BIA"	"Wine"	"1. Wine/European"	"Domesticated"
"BKL"	"Wine"	"1. Wine/European"	"Domesticated"
"BIB"	"Wine"	"1. Wine/European"	"Domesticated"
"BKK"	"Unknown"	"1. Wine/European"	"Domesticated"
"BLQ"	"Wine"	"1. Wine/European"	"Domesticated"
"SACE_YBY"	"Wine"	"1. Wine/European"	"Domesticated"
"SACE_YDF"	"Human, clinical"	"1. Wine/European"	"Domesticated"
"SACE_YDO"	"Distillery"	"1. Wine/European"	"Domesticated"
"AHG"	"Fruit"	"1. Wine/European"	"Domesticated"
"AII"	"Palm wine"	"1. Wine/European"	"Domesticated"
"AHD"	"Wine"	"1. Wine/European"	"Domesticated"
"AGF"	"Wine"	"1. Wine/European"	"Domesticated"
"AHE"	"Wine"	"1. Wine/European"	"Domesticated"
"AQQ"	"Wine"	"1. Wine/European"	"Domesticated"
"ASG"	"Human, clinical"	"1. Wine/European"	"Domesticated"
"ASD"	"Beer"	"1. Wine/European"	"Domesticated"
"ASE"	"Wine"	"1. Wine/European"	"Domesticated"
"AIQ"	"Fermentation"	"1. Wine/European"	"Domesticated"
"BLG"	"Wine"	"1. Wine/European"	"Domesticated"
"BLI"	"Wine"	"1. Wine/European"	"Domesticated"
"ACP"	"Wine"	"1. Wine/European (subclade 1)"	"Domesticated"
"BQA"	"Wine"	"1. Wine/European (subclade 1)"	"Domesticated"
"AMA"	"Fruit"	"1. Wine/European (subclade 1)"	"Domesticated"
"ALQ"	"Tree"	"1. Wine/European (subclade 1)"	"Domesticated"
"BBI"	"Flower"	"1. Wine/European (subclade 1)"	"Domesticated"
"ALT"	"Flower"	"1. Wine/European (subclade 1)"	"Domesticated"
"BBK"	"Flower"	"1. Wine/European (subclade 1)"	"Domesticated"
"BFB"	"Nature"	"1. Wine/European (subclade 1)"	"Domesticated"
"BFD"	"Fruit"	"1. Wine/European (subclade 1)"	"Domesticated"
"ALS"	"Flower"	"1. Wine/European (subclade 1)"	"Domesticated"
"BBH"	"Flower"	"1. Wine/European (subclade 1)"	"Domesticated"
"BPQ"	"Wine"	"1. Wine/European (subclade 1)"	"Domesticated"
"BQN"	"Wine"	"1. Wine/European (subclade 1)"	"Domesticated"
"CBI"	"Wine"	"1. Wine/European (subclade 1)"	"Domesticated"
"CCM"	"Tree"	"1. Wine/European (subclade 1)"	"Domesticated"
"BEP"	"Unknown"	"1. Wine/European (subclade 1)"	"Domesticated"
"BRC"	"Wine"	"1. Wine/European (subclade 1)"	"Domesticated"
"CGT"	"Wine"	"1. Wine/European (subclade 1)"	"Domesticated"
"ALL"	"Water"	"1. Wine/European"	"Domesticated"
"ALM"	"Water"	"1. Wine/European"	"Domesticated"
"AVH"	"Wine"	"1. Wine/European"	"Domesticated"
"AHR"	"Human, clinical"	"1. Wine/European"	"Domesticated"
"SACE_YAD"	"Human, clinical"	"1. Wine/European"	"Domesticated"
"AGH"	"Wine"	"1. Wine/European"	"Domesticated"
"BTH"	"Tree"	"1. Wine/European"	"Domesticated"
"ATH"	"Wine"	"1. Wine/European"	"Domesticated"
"BFQ"	"Cider"	"1. Wine/European"	"Domesticated"
"CIA"	"Industrial"	"1. Wine/European"	"Domesticated"
"BFR"	"Cider"	"1. Wine/European"	"Domesticated"
"CIB"	"Industrial"	"1. Wine/European"	"Domesticated"
"CBG"	"Wine"	"1. Wine/European"	"Domesticated"
"ACF"	"Distillery"	"1. Wine/European"	"Domesticated"
"SACE_YCD"	"Cider"	"1. Wine/European"	"Domesticated"
"APS"	"Wine"	"1. Wine/European"	"Domesticated"
"ARC"	"Wine"	"1. Wine/European"	"Domesticated"
"BER"	"Wine"	"1. Wine/European"	"Domesticated"
"BES"	"Wine"	"1. Wine/European"	"Domesticated"
"ARK"	"Fruit"	"1. Wine/European"	"Domesticated"
"ATA"	"Wine"	"1. Wine/European"	"Domesticated"
"ARQ"	"Wine"	"1. Wine/European"	"Domesticated"
"SACE_YBN"	"Fruit"	"1. Wine/European"	"Domesticated"
"APV"	"Wine"	"1. Wine/European"	"Domesticated"
"CFV"	"Fruit"	"1. Wine/European"	"Domesticated"
"SACE_YDC"	"Beer"	"1. Wine/European"	"Domesticated"
"SACE_GAP"	"Wine"	"1. Wine/European"	"Domesticated"
"AAI"	"Distillery"	"1. Wine/European"	"Domesticated"
"ARV"	"Distillery"	"1. Wine/European"	"Domesticated"
"BHC"	"Cider"	"1. Wine/European"	"Domesticated"
"BHF"	"Cider"	"1. Wine/European"	"Domesticated"
"BLB"	"Wine"	"1. Wine/European"	"Domesticated"
"BPP"	"Wine"	"1. Wine/European"	"Domesticated"
"BTN"	"Wine"	"1. Wine/European"	"Domesticated"
"BTL"	"Wine"	"1. Wine/European"	"Domesticated"
"CRH"	"Wine"	"1. Wine/European"	"Domesticated"
"SACE_YAA"	"Distillery"	"1. Wine/European"	"Domesticated"
"BSP"	"Wine"	"1. Wine/European"	"Domesticated"
"AHT"	"Fermentation"	"1. Wine/European"	"Domesticated"
"ATN"	"Fruit"	"1. Wine/European"	"Domesticated"
"SACE_YBO"	"Fruit"	"1. Wine/European"	"Domesticated"
"BNK"	"Wine"	"1. Wine/European"	"Domesticated"
"BNR"	"Wine"	"1. Wine/European"	"Domesticated"
"BQH"	"Wine"	"1. Wine/European"	"Domesticated"
"BEQ"	"Wine"	"1. Wine/European"	"Domesticated"
"AIK"	"Nature"	"1. Wine/European"	"Domesticated"
"CAH"	"Wine"	"1. Wine/European"	"Domesticated"
"CBA"	"Wine"	"1. Wine/European"	"Domesticated"
"CAI"	"Wine"	"1. Wine/European"	"Domesticated"
"CAK"	"Wine"	"1. Wine/European"	"Domesticated"
"CAL"	"Wine"	"1. Wine/European"	"Domesticated"
"BSL"	"Wine"	"1. Wine/European"	"Domesticated"
"SACE_YBX"	"Wine"	"1. Wine/European"	"Domesticated"
"BSE"	"Wine"	"1. Wine/European"	"Domesticated"
"AAA"	"Wine"	"1. Wine/European"	"Domesticated"
"CFS"	"Wine"	"1. Wine/European"	"Domesticated"
"BEV"	"Water"	"1. Wine/European"	"Domesticated"
"BET"	"Water"	"1. Wine/European"	"Domesticated"
"BST"	"Wine"	"1. Wine/European"	"Domesticated"
"ASS"	"Wine"	"1. Wine/European"	"Domesticated"
"BSD"	"Wine"	"1. Wine/European"	"Domesticated"
"ATM"	"Wine"	"1. Wine/European"	"Domesticated"
"CQT"	"Wine"	"1. Wine/European"	"Domesticated"
"BSA"	"Wine"	"1. Wine/European"	"Domesticated"
"ADR"	"Wine"	"1. Wine/European"	"Domesticated"
"BSC"	"Wine"	"1. Wine/European"	"Domesticated"
"CFQ"	"Wine"	"1. Wine/European"	"Domesticated"
"CFR"	"Wine"	"1. Wine/European"	"Domesticated"
"BSB"	"Wine"	"1. Wine/European"	"Domesticated"
"ADC"	"Wine"	"1. Wine/European"	"Domesticated"
"SACE_YCP"	"Wine"	"1. Wine/European"	"Domesticated"
"SACE_YCQ"	"Cider"	"1. Wine/European"	"Domesticated"
"BII"	"Wine"	"1. Wine/European"	"Domesticated"
"BIS"	"Wine"	"1. Wine/European"	"Domesticated"
"BIG"	"Wine"	"1. Wine/European"	"Domesticated"
"AIR"	"Wine"	"1. Wine/European"	"Domesticated"
"AIT"	"Wine"	"1. Wine/European"	"Domesticated"
"BNF"	"Wine"	"1. Wine/European"	"Domesticated"
"BAR"	"Tree"	"1. Wine/European"	"Domesticated"
"BAS"	"Soil"	"1. Wine/European"	"Domesticated"
"BAT"	"Soil"	"1. Wine/European"	"Domesticated"
"BRD"	"Unknown"	"1. Wine/European"	"Domesticated"
"AGV"	"Wine"	"1. Wine/European"	"Domesticated"
"BQI"	"Wine"	"1. Wine/European"	"Domesticated"
"AGA"	"Wine"	"1. Wine/European"	"Domesticated"
"AGS"	"Wine"	"1. Wine/European"	"Domesticated"
"BPC"	"Wine"	"1. Wine/European"	"Domesticated"
"BKE"	"Wine"	"1. Wine/European"	"Domesticated"
"BLH"	"Wine"	"1. Wine/European"	"Domesticated"
"CRG"	"Wine"	"1. Wine/European"	"Domesticated"
"AIL"	"Nature"	"1. Wine/European"	"Domesticated"
"AMS"	"Probiotic"	"1. Wine/European"	"Domesticated"
"BLE"	"Wine"	"1. Wine/European"	"Domesticated"
"ADB"	"Wine"	"1. Wine/European"	"Domesticated"
"BQB"	"Wine"	"1. Wine/European"	"Domesticated"
"AMR"	"Soil"	"1. Wine/European"	"Domesticated"
"ABT"	"Nature"	"1. Wine/European"	"Domesticated"
"BRA"	"Nature"	"1. Wine/European"	"Domesticated"
"BIC"	"Wine"	"1. Wine/European"	"Domesticated"
"BLK"	"Wine"	"1. Wine/European"	"Domesticated"
"BBV"	"Wine"	"1. Wine/European"	"Domesticated"
"BVK"	"Wine"	"1. Wine/European"	"Domesticated"
"CFE"	"Beer"	"1. Wine/European"	"Domesticated"
"BRF"	"Wine"	"1. Wine/European"	"Domesticated"
"BSM"	"Wine"	"1. Wine/European"	"Domesticated"
"BSN"	"Wine"	"1. Wine/European"	"Domesticated"
"CPE"	"Unknown"	"1. Wine/European"	"Domesticated"
"BLM"	"Wine"	"1. Wine/European"	"Domesticated"
"BQC"	"Distillery"	"1. Wine/European"	"Domesticated"
"BRE"	"Wine"	"1. Wine/European"	"Domesticated"
"BPV"	"Wine"	"1. Wine/European"	"Domesticated"
"CRC"	"Wine"	"1. Wine/European"	"Domesticated"
"BHN"	"Fermentation"	"1. Wine/European"	"Domesticated"
"BBB"	"Soil"	"1. Wine/European"	"Domesticated"
"BAV"	"Wine"	"1. Wine/European"	"Domesticated"
"CAE"	"Wine"	"1. Wine/European"	"Domesticated"
"CAF"	"Wine"	"1. Wine/European"	"Domesticated"
"CRL"	"Wine"	"1. Wine/European"	"Domesticated"
"BBA"	"Soil"	"1. Wine/European"	"Domesticated"
"SACE_YAY"	"Human, clinical"	"1. Wine/European (subclade 2)"	"Domesticated"
"ADI"	"Human, clinical"	"1. Wine/European (subclade 2)"	"Domesticated"
"SACE_YBA"	"Human, clinical"	"1. Wine/European (subclade 2)"	"Domesticated"
"SACE_YAZ"	"Human, clinical"	"1. Wine/European (subclade 2)"	"Domesticated"
"BMI"	"Human, clinical"	"1. Wine/European (subclade 2)"	"Domesticated"
"SACE_YBE"	"Human, clinical"	"1. Wine/European (subclade 2)"	"Domesticated"
"BMK"	"Human, clinical"	"1. Wine/European (subclade 2)"	"Domesticated"
"SACE_YBF"	"Human, clinical"	"1. Wine/European (subclade 2)"	"Domesticated"
"BMH"	"Human, clinical"	"1. Wine/European (subclade 2)"	"Domesticated"
"ADD"	"Soil"	"1. Wine/European (subclade 2)"	"Domesticated"
"SACE_YBB"	"Human, clinical"	"1. Wine/European (subclade 2)"	"Domesticated"
"SACE_YBG"	"Human, clinical"	"1. Wine/European (subclade 2)"	"Domesticated"
"SACE_YBH"	"Human, clinical"	"1. Wine/European (subclade 2)"	"Domesticated"
"CDS"	"Fruit"	"1. Wine/European"	"Domesticated"
"BIM"	"Wine"	"1. Wine/European"	"Domesticated"
"BIN"	"Wine"	"1. Wine/European"	"Domesticated"
"BKA"	"Fruit"	"1. Wine/European"	"Domesticated"
"BQQ"	"Wine"	"1. Wine/European"	"Domesticated"
"ADS"	"Wine"	"1. Wine/European"	"Domesticated"
"BNM"	"Wine"	"1. Wine/European"	"Domesticated"
"ACR"	"Wine"	"1. Wine/European"	"Domesticated"
"BIH"	"Wine"	"1. Wine/European"	"Domesticated"
"BKC"	"Wine"	"1. Wine/European"	"Domesticated"
"BLS"	"Wine"	"1. Wine/European"	"Domesticated"
"BKD"	"Soil"	"1. Wine/European"	"Domesticated"
"BNP"	"Wine"	"1. Wine/European"	"Domesticated"
"BKN"	"Wine"	"1. Wine/European"	"Domesticated"
"BNQ"	"Wine"	"1. Wine/European"	"Domesticated"
"CBH"	"Wine"	"1. Wine/European"	"Domesticated"
"BKH"	"Wine"	"1. Wine/European"	"Domesticated"
"BPM"	"Wine"	"1. Wine/European"	"Domesticated"
"BKP"	"Wine"	"1. Wine/European"	"Domesticated"
"CRA"	"Wine"	"1. Wine/European"	"Domesticated"
"CRB"	"Wine"	"1. Wine/European"	"Domesticated"
"CHC"	"Wine"	"1. Wine/European"	"Domesticated"
"CGS"	"Wine"	"1. Wine/European"	"Domesticated"
"CHB"	"Wine"	"1. Wine/European"	"Domesticated"
"CHD"	"Wine"	"1. Wine/European"	"Domesticated"
"CGV"	"Wine"	"1. Wine/European"	"Domesticated"
"CHA"	"Wine"	"1. Wine/European"	"Domesticated"
"CHE"	"Wine"	"1. Wine/European"	"Domesticated"
"AHI"	"Wine"	"1. Wine/European"	"Domesticated"
"BKM"	"Wine"	"1. Wine/European"	"Domesticated"
"BIF"	"Wine"	"1. Wine/European"	"Domesticated"
"BKG"	"Wine"	"1. Wine/European"	"Domesticated"
"BKF"	"Wine"	"1. Wine/European"	"Domesticated"
"BLL"	"Wine"	"1. Wine/European"	"Domesticated"
"ARL"	"Flower"	"1. Wine/European"	"Domesticated"
"CKI"	"Human, clinical"	"1. Wine/European (subclade 3)"	"Domesticated"
"CKL"	"Human, clinical"	"1. Wine/European (subclade 3)"	"Domesticated"
"CKH"	"Industrial"	"1. Wine/European (subclade 3)"	"Domesticated"
"CKD"	"Human, clinical"	"1. Wine/European (subclade 3)"	"Domesticated"
"CKE"	"Human, clinical"	"1. Wine/European (subclade 3)"	"Domesticated"
"CIS"	"Human, clinical"	"1. Wine/European (subclade 3)"	"Domesticated"
"BMN"	"Human, clinical"	"1. Wine/European (subclade 3)"	"Domesticated"
"CIT"	"Human, clinical"	"1. Wine/European (subclade 3)"	"Domesticated"
"CKP"	"Human, clinical"	"1. Wine/European (subclade 3)"	"Domesticated"
"CKQ"	"Human, clinical"	"1. Wine/European (subclade 3)"	"Domesticated"
"CKB"	"Human, clinical"	"1. Wine/European (subclade 3)"	"Domesticated"
"CKC"	"Human, clinical"	"1. Wine/European (subclade 3)"	"Domesticated"
"CIQ"	"Human, clinical"	"1. Wine/European (subclade 3)"	"Domesticated"
"CIM"	"Human, clinical"	"1. Wine/European (subclade 3)"	"Domesticated"
"CIN"	"Human, clinical"	"1. Wine/European (subclade 3)"	"Domesticated"
"CIR"	"Human, clinical"	"1. Wine/European (subclade 3)"	"Domesticated"
"CKF"	"Human, clinical"	"1. Wine/European (subclade 3)"	"Domesticated"
"CKG"	"Fruit"	"1. Wine/European (subclade 3)"	"Domesticated"
"CKM"	"Human, clinical"	"1. Wine/European (subclade 3)"	"Domesticated"
"CIP"	"Human, clinical"	"1. Wine/European (subclade 3)"	"Domesticated"
"BCA"	"Human, clinical"	"1. Wine/European (subclade 3)"	"Domesticated"
"AMT"	"Probiotic"	"1. Wine/European (subclade 3)"	"Domesticated"
"CIV"	"Human, clinical"	"1. Wine/European (subclade 3)"	"Domesticated"
"CKT"	"Human, clinical"	"1. Wine/European (subclade 3)"	"Domesticated"
"BIL"	"Wine"	"1. Wine/European"	"Domesticated"
"ABS"	"Nature"	"1. Wine/European"	"Domesticated"
"BIP"	"Wine"	"1. Wine/European"	"Domesticated"
"BIQ"	"Wine"	"1. Wine/European"	"Domesticated"
"BNI"	"Wine"	"1. Wine/European"	"Domesticated"
"BLV"	"Wine"	"1. Wine/European"	"Domesticated"
"BQG"	"Wine"	"1. Wine/European"	"Domesticated"
"CRD"	"Wine"	"1. Wine/European"	"Domesticated"
"CRI"	"Wine"	"1. Wine/European"	"Domesticated"
"BVM"	"Wine"	"1. Wine/European"	"Domesticated"
"CQV"	"Wine"	"1. Wine/European"	"Domesticated"
"CRK"	"Wine"	"1. Wine/European"	"Domesticated"
"BLF"	"Wine"	"1. Wine/European"	"Domesticated"
"CEA"	"Soil"	"1. Wine/European"	"Domesticated"
"CEB"	"Soil"	"1. Wine/European"	"Domesticated"
"BNT"	"Soil"	"1. Wine/European"	"Domesticated"
"BLD"	"Wine"	"1. Wine/European"	"Domesticated"
"BKR"	"Wine"	"1. Wine/European"	"Domesticated"
"CEC"	"Soil"	"1. Wine/European"	"Domesticated"
"BNH"	"Wine"	"1. Wine/European"	"Domesticated"
"BLC"	"Wine"	"1. Wine/European"	"Domesticated"
"CEE"	"Soil"	"1. Wine/European"	"Domesticated"
"BNN"	"Wine"	"1. Wine/European"	"Domesticated"
"CED"	"Soil"	"1. Wine/European"	"Domesticated"
"BKS"	"Wine"	"1. Wine/European"	"Domesticated"
"BLP"	"Wine"	"1. Wine/European"	"Domesticated"
"BLN"	"Wine"	"1. Wine/European"	"Domesticated"
"CDV"	"Soil"	"1. Wine/European"	"Domesticated"
"CEF"	"Soil"	"1. Wine/European"	"Domesticated"
"ANQ"	"Wine"	"1. Wine/European"	"Domesticated"
"AVK"	"Wine"	"1. Wine/European"	"Domesticated"
"BIK"	"Wine"	"1. Wine/European"	"Domesticated"
"CLH"	"Wine"	"1. Wine/European"	"Domesticated"
"AHN"	"Wine"	"1. Wine/European"	"Domesticated"
"BSG"	"Wine"	"1. Wine/European"	"Domesticated"
"SACE_YCA"	"Wine"	"1. Wine/European"	"Domesticated"
"ACT"	"Wine"	"1. Wine/European"	"Domesticated"
"ACV"	"Wine"	"1. Wine/European"	"Domesticated"
"AKP"	"Industrial"	"1. Wine/European"	"Domesticated"
"AKV"	"Nature"	"1. Wine/European"	"Domesticated"
"ALE"	"Insect"	"1. Wine/European"	"Domesticated"
"BQP"	"Wine"	"1. Wine/European"	"Domesticated"
"BRB"	"Wine"	"1. Wine/European"	"Domesticated"
"BIT"	"Wine"	"1. Wine/European"	"Domesticated"
"AQB"	"Wine"	"1. Wine/European"	"Domesticated"
"BRH"	"Wine"	"1. Wine/European"	"Domesticated"
"ABP"	"Fruit"	"1. Wine/European"	"Domesticated"
"BIR"	"Wine"	"1. Wine/European"	"Domesticated"
"CPF"	"Unknown"	"1. Wine/European"	"Domesticated"
"BNG"	"Wine"	"1. Wine/European"	"Domesticated"
"AIM"	"Wine"	"1. Wine/European"	"Domesticated"
"CFB"	"Wine"	"1. Wine/European"	"Domesticated"
"CHF"	"Wine"	"1. Wine/European"	"Domesticated"
"BHB"	"Bakery"	"1. Wine/European"	"Domesticated"
"AAK"	"Wine"	"1. Wine/European (subclade 4)"	"Domesticated"
"AHP"	"Wine"	"1. Wine/European (subclade 4)"	"Domesticated"
"AET"	"Wine"	"1. Wine/European (subclade 4)"	"Domesticated"
"AEK"	"Wine"	"1. Wine/European (subclade 4)"	"Domesticated"
"AQE"	"Wine"	"1. Wine/European (subclade 4)"	"Domesticated"
"AQP"	"Wine"	"1. Wine/European (subclade 4)"	"Domesticated"
"ASA"	"Wine"	"1. Wine/European (subclade 4)"	"Domesticated"
"BPL"	"Wine"	"1. Wine/European (subclade 4)"	"Domesticated"
"AIP"	"Wine"	"1. Wine/European (subclade 4)"	"Domesticated"
"CAN"	"Wine"	"1. Wine/European (subclade 4)"	"Domesticated"
"CAB"	"Wine"	"1. Wine/European (subclade 4)"	"Domesticated"
"CAP"	"Wine"	"1. Wine/European (subclade 4)"	"Domesticated"
"AQC"	"Wine"	"1. Wine/European (subclade 4)"	"Domesticated"
"AHK"	"Wine"	"1. Wine/European (subclade 4)"	"Domesticated"
"AES"	"Wine"	"1. Wine/European (subclade 4)"	"Domesticated"
"AFI"	"Wine"	"1. Wine/European (subclade 4)"	"Domesticated"
"BPR"	"Nature"	"1. Wine/European (subclade 4)"	"Domesticated"
"AIA"	"Wine"	"1. Wine/European (subclade 4)"	"Domesticated"
"BVT"	"Wine"	"1. Wine/European (subclade 4)"	"Domesticated"
"CAA"	"Wine"	"1. Wine/European (subclade 4)"	"Domesticated"
"CAC"	"Wine"	"1. Wine/European (subclade 4)"	"Domesticated"
"BVV"	"Wine"	"1. Wine/European (subclade 4)"	"Domesticated"
"CAD"	"Wine"	"1. Wine/European (subclade 4)"	"Domesticated"
"CAM"	"Wine"	"1. Wine/European (subclade 4)"	"Domesticated"
"CAQ"	"Wine"	"1. Wine/European (subclade 4)"	"Domesticated"
"CBB"	"Wine"	"1. Wine/European (subclade 4)"	"Domesticated"
"CBE"	"Wine"	"1. Wine/European (subclade 4)"	"Domesticated"
"AAE"	"Wine"	"1. Wine/European (subclade 4)"	"Domesticated"
"AIB"	"Wine"	"1. Wine/European (subclade 4)"	"Domesticated"
"CAS"	"Wine"	"1. Wine/European (subclade 4)"	"Domesticated"
"CAR"	"Wine"	"1. Wine/European (subclade 4)"	"Domesticated"
"CAT"	"Wine"	"1. Wine/European (subclade 4)"	"Domesticated"
"CBC"	"Wine"	"1. Wine/European (subclade 4)"	"Domesticated"
"CAV"	"Wine"	"1. Wine/European (subclade 4)"	"Domesticated"
"CBD"	"Wine"	"1. Wine/European (subclade 4)"	"Domesticated"
"AFV"	"Wine"	"1. Wine/European (subclade 4)"	"Domesticated"
"ART"	"Wine"	"1. Wine/European (subclade 4)"	"Domesticated"
"AIC"	"Wine"	"1. Wine/European (subclade 4)"	"Domesticated"
"SACE_YAF"	"Wine"	"1. Wine/European (subclade 4)"	"Domesticated"
"BSR"	"Wine"	"1. Wine/European"	"Domesticated"
"BSS"	"Wine"	"1. Wine/European"	"Domesticated"
"BTR"	"Wine"	"1. Wine/European"	"Domesticated"
"BTP"	"Wine"	"1. Wine/European"	"Domesticated"
"ASR"	"Wine"	"1. Wine/European"	"Domesticated"
"SACE_YDJ"	"Wine"	"1. Wine/European"	"Domesticated"
"AVB"	"Industrial"	"2. Alpechin"	"NA"
"CDT"	"Insect"	"2. Alpechin"	"NA"
"CPG"	"Nature"	"2. Alpechin"	"NA"
"ABM"	"Industrial"	"2. Alpechin"	"NA"
"AHM"	"Industrial"	"2. Alpechin"	"NA"
"AQA"	"Industrial"	"2. Alpechin"	"NA"
"AQD"	"Industrial"	"2. Alpechin"	"NA"
"ATQ"	"Industrial"	"2. Alpechin"	"NA"
"CGD"	"Fruit"	"2. Alpechin"	"NA"
"CGE"	"Fruit"	"2. Alpechin"	"NA"
"AHL"	"Industrial"	"2. Alpechin"	"NA"
"BRK"	"Industrial"	"2. Alpechin"	"NA"
"SACE_YBR"	"Industrial"	"2. Alpechin"	"NA"
"AID"	"Human"	"2. Alpechin"	"NA"
"AIE"	"Human"	"2. Alpechin"	"NA"
"SACE_YAE"	"Human"	"2. Alpechin"	"NA"
"SACE_YDM"	"Human, clinical"	"2. Alpechin"	"NA"
"AGN"	"Wine"	"M1. Mosaic region 1"	"NA"
"AST"	"Wine"	"M1. Mosaic region 1"	"NA"
"BHE"	"Cider"	"M1. Mosaic region 1"	"NA"
"BHD"	"Cider"	"M1. Mosaic region 1"	"NA"
"BHM"	"Cider"	"M1. Mosaic region 1"	"NA"
"BHT"	"Cider"	"M1. Mosaic region 1"	"NA"
"ASV"	"Wine"	"M1. Mosaic region 1"	"NA"
"AHF"	"Nature"	"M1. Mosaic region 1"	"NA"
"AMP"	"Fruit"	"M1. Mosaic region 1"	"NA"
"CPB"	"Beer"	"M1. Mosaic region 1"	"NA"
"ACS"	"Wine"	"M1. Mosaic region 1"	"NA"
"SACE_YCI"	"Wine"	"M1. Mosaic region 1"	"NA"
"BHL"	"Cider"	"M1. Mosaic region 1"	"NA"
"BHK"	"Cider"	"M1. Mosaic region 1"	"NA"
"ACG"	"Fermentation"	"M1. Mosaic region 1"	"NA"
"ACH"	"Cider"	"M1. Mosaic region 1"	"NA"
"CHV"	"Cider"	"M1. Mosaic region 1"	"NA"
"AFR"	"Industrial"	"3. Brazilian bioethanol"	"Domesticated"
"BVC"	"Bioethanol"	"3. Brazilian bioethanol"	"Domesticated"
"AEG"	"Industrial"	"3. Brazilian bioethanol"	"Domesticated"
"AGM"	"Industrial"	"3. Brazilian bioethanol"	"Domesticated"
"CNQ"	"Bioethanol"	"3. Brazilian bioethanol"	"Domesticated"
"AEH"	"Industrial"	"3. Brazilian bioethanol"	"Domesticated"
"AFD"	"Industrial"	"3. Brazilian bioethanol"	"Domesticated"
"AHC"	"Industrial"	"3. Brazilian bioethanol"	"Domesticated"
"BTT"	"Distillery"	"3. Brazilian bioethanol"	"Domesticated"
"APH"	"Distillery"	"3. Brazilian bioethanol"	"Domesticated"
"BTV"	"Distillery"	"3. Brazilian bioethanol"	"Domesticated"
"BVA"	"Bioethanol"	"3. Brazilian bioethanol"	"Domesticated"
"CMT"	"Bioethanol"	"3. Brazilian bioethanol"	"Domesticated"
"CNG"	"Bioethanol"	"3. Brazilian bioethanol"	"Domesticated"
"CNK"	"Bioethanol"	"3. Brazilian bioethanol"	"Domesticated"
"APG"	"Bioethanol"	"3. Brazilian bioethanol"	"Domesticated"
"CNM"	"Bioethanol"	"3. Brazilian bioethanol"	"Domesticated"
"CNP"	"Bioethanol"	"3. Brazilian bioethanol"	"Domesticated"
"CNR"	"Bioethanol"	"3. Brazilian bioethanol"	"Domesticated"
"BVB"	"Bioethanol"	"3. Brazilian bioethanol"	"Domesticated"
"CNI"	"Bioethanol"	"3. Brazilian bioethanol"	"Domesticated"
"CNH"	"Bioethanol"	"3. Brazilian bioethanol"	"Domesticated"
"BVH"	"Bioethanol"	"3. Brazilian bioethanol"	"Domesticated"
"CNN"	"Bioethanol"	"3. Brazilian bioethanol"	"Domesticated"
"CNF"	"Bioethanol"	"3. Brazilian bioethanol"	"Domesticated"
"CNB"	"Bioethanol"	"3. Brazilian bioethanol"	"Domesticated"
"BVG"	"Bioethanol"	"3. Brazilian bioethanol"	"Domesticated"
"CNE"	"Bioethanol"	"3. Brazilian bioethanol"	"Domesticated"
"CNL"	"Bioethanol"	"3. Brazilian bioethanol"	"Domesticated"
"BVD"	"Bioethanol"	"3. Brazilian bioethanol"	"Domesticated"
"BVF"	"Bioethanol"	"3. Brazilian bioethanol"	"Domesticated"
"CNS"	"Bioethanol"	"3. Brazilian bioethanol"	"Domesticated"
"CNT"	"Bioethanol"	"3. Brazilian bioethanol"	"Domesticated"
"BVE"	"Bioethanol"	"3. Brazilian bioethanol"	"Domesticated"
"CNV"	"Bioethanol"	"3. Brazilian bioethanol"	"Domesticated"
"AHB"	"Nature"	NA	"NA"
"SACE_YBQ"	"Nature"	NA	"NA"
"CCL"	"Tree"	"4. Mediterranean oak"	"Wild"
"BBQ"	"Soil"	"4. Mediterranean oak"	"Wild"
"BBS"	"Soil"	"4. Mediterranean oak"	"Wild"
"BFP"	"Tree"	"4. Mediterranean oak"	"Wild"
"BTG"	"Tree"	"4. Mediterranean oak"	"Wild"
"CLC"	"Tree"	"4. Mediterranean oak"	"Wild"
"CLB"	"Tree"	"4. Mediterranean oak"	"Wild"
"CLD"	"Flower"	"4. Mediterranean oak"	"Wild"
"AQM"	"Dairy"	"5. French dairy"	"Domesticated"
"BFN"	"Tree"	"5. French dairy"	"Domesticated"
"BME"	"Human"	"5. French dairy"	"Domesticated"
"ARS"	"Nature"	"5. French dairy"	"Domesticated"
"ARN"	"Human, clinical"	"5. French dairy"	"Domesticated"
"BGM"	"Dairy"	"5. French dairy"	"Domesticated"
"BGP"	"Dairy"	"5. French dairy"	"Domesticated"
"BFH"	"Dairy"	"5. French dairy"	"Domesticated"
"BGR"	"Dairy"	"5. French dairy"	"Domesticated"
"ASN"	"Dairy"	"5. French dairy"	"Domesticated"
"BGK"	"Dairy"	"5. French dairy"	"Domesticated"
"BGS"	"Dairy"	"5. French dairy"	"Domesticated"
"BGD"	"Dairy"	"5. French dairy"	"Domesticated"
"BGI"	"Dairy"	"5. French dairy"	"Domesticated"
"ALD"	"Nature"	"5. French dairy"	"Domesticated"
"BFS"	"Dairy"	"5. French dairy"	"Domesticated"
"BGB"	"Dairy"	"5. French dairy"	"Domesticated"
"BGF"	"Dairy"	"5. French dairy"	"Domesticated"
"BGG"	"Dairy"	"5. French dairy"	"Domesticated"
"ARR"	"Dairy"	"5. French dairy"	"Domesticated"
"BFT"	"Dairy"	"5. French dairy"	"Domesticated"
"BGE"	"Dairy"	"5. French dairy"	"Domesticated"
"BGL"	"Dairy"	"5. French dairy"	"Domesticated"
"BFV"	"Dairy"	"5. French dairy"	"Domesticated"
"BGA"	"Dairy"	"5. French dairy"	"Domesticated"
"BGT"	"Dairy"	"5. French dairy"	"Domesticated"
"BGV"	"Dairy"	"5. French dairy"	"Domesticated"
"BGH"	"Dairy"	"5. French dairy"	"Domesticated"
"BGN"	"Dairy"	"5. French dairy"	"Domesticated"
"BGC"	"Dairy"	"5. French dairy"	"Domesticated"
"BGQ"	"Dairy"	"5. French dairy"	"Domesticated"
"CKV"	"Human, clinical"	"5. French dairy"	"Domesticated"
"AFL"	"Beer"	"6. African beer"	"Domesticated"
"AEN"	"Beer"	"6. African beer"	"Domesticated"
"ASC"	"Beer"	"6. African beer"	"Domesticated"
"ANL"	"Beer"	"6. African beer"	"Domesticated"
"ANM"	"Beer"	"6. African beer"	"Domesticated"
"AVN"	"Beer"	"6. African beer"	"Domesticated"
"AVP"	"Beer"	"6. African beer"	"Domesticated"
"AVQ"	"Beer"	"6. African beer"	"Domesticated"
"AVR"	"Beer"	"6. African beer"	"Domesticated"
"AVS"	"Beer"	"6. African beer"	"Domesticated"
"AVT"	"Beer"	"6. African beer"	"Domesticated"
"BEK"	"Beer"	"6. African beer"	"Domesticated"
"BEM"	"Beer"	"6. African beer"	"Domesticated"
"BEI"	"Beer"	"6. African beer"	"Domesticated"
"BEN"	"Beer"	"6. African beer"	"Domesticated"
"BHA"	"Beer"	"6. African beer"	"Domesticated"
"BDN"	"Nature"	"6. African beer"	"Domesticated"
"CES"	"Bakery"	"6. African beer"	"Domesticated"
"CER"	"Bakery"	"6. African beer"	"Domesticated"
"CET"	"Bakery"	"6. African beer"	"Domesticated"
"BPI"	"Unknown"	NA	"NA"
"BPN"	"Wine"	NA	"NA"
"SACE_YDB"	"Unknown"	NA	"NA"
"AAB"	"Beer"	"7. Mosaic beer"	"Domesticated"
"CBN"	"Beer"	"7. Mosaic beer"	"Domesticated"
"AQG"	"Beer"	"7. Mosaic beer"	"Domesticated"
"CFF"	"Beer"	"7. Mosaic beer"	"Domesticated"
"AFB"	"Beer"	"7. Mosaic beer"	"Domesticated"
"AFA"	"Beer"	"7. Mosaic beer"	"Domesticated"
"AFP"	"Beer"	"7. Mosaic beer"	"Domesticated"
"AQH"	"Industrial"	"7. Mosaic beer"	"Domesticated"
"SACE_YAB"	"Distillery"	"7. Mosaic beer"	"Domesticated"
"AAR"	"Beer"	"7. Mosaic beer"	"Domesticated"
"AEA"	"Industrial"	"7. Mosaic beer"	"Domesticated"
"BRM"	"Distillery"	"7. Mosaic beer"	"Domesticated"
"AEQ"	"Beer"	"7. Mosaic beer"	"Domesticated"
"SACE_YAG"	"Beer"	"7. Mosaic beer"	"Domesticated"
"AAQ"	"Beer"	"7. Mosaic beer"	"Domesticated"
"ASB"	"Human, clinical"	"7. Mosaic beer"	"Domesticated"
"APP"	"Beer"	"7. Mosaic beer"	"Domesticated"
"CPD"	"Beer"	"7. Mosaic beer"	"Domesticated"
"AIG"	"Beer"	"7. Mosaic beer"	"Domesticated"
"ARE"	"Tree"	"7. Mosaic beer"	"Domesticated"
"SACE_YDD"	"Fermentation"	"7. Mosaic beer"	"Domesticated"
"AFQ"	"Water"	"M2. Mosaic region 2"	"NA"
"CDM"	"Water"	"M2. Mosaic region 2"	"NA"
"SACE_YCF"	"Fruit"	"M2. Mosaic region 2"	"NA"
"CFT"	"Fruit"	"M2. Mosaic region 2"	"NA"
"AER"	"Industrial"	"M2. Mosaic region 2"	"NA"
"BCV"	"Nature"	"M2. Mosaic region 2"	"NA"
"BDB"	"Nature"	"M2. Mosaic region 2"	"NA"
"BDD"	"Nature"	"M2. Mosaic region 2"	"NA"
"BDA"	"Nature"	"M2. Mosaic region 2"	"NA"
"BDE"	"Nature"	"M2. Mosaic region 2"	"NA"
"BDH"	"Nature"	"M2. Mosaic region 2"	"NA"
"BDI"	"Nature"	"M2. Mosaic region 2"	"NA"
"BDK"	"Nature"	"M2. Mosaic region 2"	"NA"
"SACE_YCT"	"Wine"	"M2. Mosaic region 2"	"NA"
"SACE_YCC"	"Industrial"	"M2. Mosaic region 2"	"NA"
"BHG"	"Cider"	"M2. Mosaic region 2"	"NA"
"BHH"	"Cider"	"M2. Mosaic region 2"	"NA"
"BHI"	"Cider"	"M2. Mosaic region 2"	"NA"
"SACE_MAA"	"Human, clinical"	"M2. Mosaic region 2"	"NA"
"SACE_YCZ"	"Human, clinical"	"M2. Mosaic region 2"	"NA"
"AFF"	"Bakery"	"8. Mixed origin"	"NA"
"AAL"	"Bakery"	"8. Mixed origin"	"NA"
"AAM"	"Bakery"	"8. Mixed origin"	"NA"
"ANP"	"Insect"	"8. Mixed origin"	"NA"
"AHV"	"Beer"	"8. Mixed origin"	"NA"
"ATS"	"Flower"	"8. Mixed origin"	"NA"
"BBP"	"Flower"	"8. Mixed origin"	"NA"
"CDR"	"Flower"	"8. Mixed origin"	"NA"
"BMG"	"Human, clinical"	"8. Mixed origin"	"NA"
"CHL"	"Bakery"	"8. Mixed origin"	"NA"
"ADP"	"Unknown"	"8. Mixed origin"	"NA"
"AMK"	"Tree"	"8. Mixed origin"	"NA"
"AML"	"Tree"	"8. Mixed origin"	"NA"
"AMI"	"Tree"	"8. Mixed origin"	"NA"
"AMG"	"Tree"	"8. Mixed origin"	"NA"
"AMQ"	"Tree"	"8. Mixed origin"	"NA"
"APK"	"Bakery"	"8. Mixed origin"	"NA"
"APN"	"Bakery"	"8. Mixed origin"	"NA"
"CIE"	"Human, clinical"	"8. Mixed origin"	"NA"
"AEM"	"Beer"	"8. Mixed origin"	"NA"
"AFT"	"Human, clinical"	"8. Mixed origin"	"NA"
"AQI"	"Water"	"8. Mixed origin"	"NA"
"AFE"	"Water"	"8. Mixed origin"	"NA"
"ATR"	"Fruit"	"8. Mixed origin"	"NA"
"AFC"	"Nature"	"8. Mixed origin"	"NA"
"APM"	"Bakery"	"8. Mixed origin"	"NA"
"API"	"Bakery"	"8. Mixed origin"	"NA"
"ASL"	"Bakery"	"8. Mixed origin"	"NA"
"BTF"	"Bakery"	"8. Mixed origin"	"NA"
"ASP"	"Unknown"	"8. Mixed origin"	"NA"
"BCR"	"Nature"	"8. Mixed origin"	"NA"
"BCS"	"Nature"	"8. Mixed origin"	"NA"
"BCT"	"Nature"	"8. Mixed origin"	"NA"
"AGK"	"Nature"	"8. Mixed origin"	"NA"
"AGE"	"Bakery"	"8. Mixed origin"	"NA"
"BTC"	"Bakery"	"8. Mixed origin"	"NA"
"ABV"	"Water"	"8. Mixed origin"	"NA"
"ALV"	"Fruit"	"8. Mixed origin"	"NA"
"BBC"	"Fruit"	"8. Mixed origin"	"NA"
"AMN"	"Tree"	"8. Mixed origin"	"NA"
"CFP"	"Beer"	"8. Mixed origin"	"NA"
"BBF"	"Water"	"8. Mixed origin"	"NA"
"AAP"	"Bakery"	"8. Mixed origin"	"NA"
"ALN"	"Water"	"8. Mixed origin"	"NA"
"ALP"	"Water"	"8. Mixed origin"	"NA"
"BBD"	"Water"	"8. Mixed origin"	"NA"
"BBE"	"Water"	"8. Mixed origin"	"NA"
"AAN"	"Bakery"	"8. Mixed origin"	"NA"
"CHI"	"Bakery"	"8. Mixed origin"	"NA"
"APL"	"Bakery"	"8. Mixed origin"	"NA"
"AEV"	"Water"	"8. Mixed origin"	"NA"
"CFI"	"Beer"	"8. Mixed origin"	"NA"
"CFN"	"Beer"	"8. Mixed origin"	"NA"
"CHK"	"Beer"	"8. Mixed origin"	"NA"
"CHH"	"Bakery"	"8. Mixed origin"	"NA"
"ADL"	"Bakery"	"8. Mixed origin"	"NA"
"BDL"	"Beer"	"8. Mixed origin"	"NA"
"BFM"	"Industrial"	"8. Mixed origin"	"NA"
"BFE"	"Industrial"	"8. Mixed origin"	"NA"
"BFG"	"Nature"	"8. Mixed origin"	"NA"
"BTD"	"Bakery"	"8. Mixed origin"	"NA"
"ADM"	"Bakery"	"8. Mixed origin"	"NA"
"AKT"	"Insect"	"8. Mixed origin"	"NA"
"CHG"	"Bakery"	"8. Mixed origin"	"NA"
"CHR"	"Human, clinical"	"8. Mixed origin"	"NA"
"BML"	"Human, clinical"	"8. Mixed origin"	"NA"
"BTE"	"Bakery"	"8. Mixed origin"	"NA"
"BMM"	"Human, clinical"	"8. Mixed origin"	"NA"
"CBF"	"Bakery"	"8. Mixed origin"	"NA"
"CKK"	"Human, clinical"	"8. Mixed origin"	"NA"
"CKS"	"Human, clinical"	"8. Mixed origin"	"NA"
"CLA"	"Human, clinical"	"8. Mixed origin"	"NA"
"SACE_YBW"	"Human, clinical"	NA	"NA"
"CPI"	"Distillery"	"9. Mexican agave"	"Domesticated"
"CPM"	"Distillery"	"9. Mexican agave"	"Domesticated"
"CPK"	"Distillery"	"9. Mexican agave"	"Domesticated"
"CPL"	"Distillery"	"9. Mexican agave"	"Domesticated"
"CPQ"	"Distillery"	"9. Mexican agave"	"Domesticated"
"CPN"	"Distillery"	"9. Mexican agave"	"Domesticated"
"CPR"	"Distillery"	"9. Mexican agave"	"Domesticated"
"ALI"	"Water"	NA	"NA"
"BCG"	"Human"	"10. French Guiana human"	"NA"
"BCB"	"Human"	"10. French Guiana human"	"NA"
"BCM"	"Human"	"10. French Guiana human"	"NA"
"BDT"	"Human"	"10. French Guiana human"	"NA"
"BCF"	"Human"	"10. French Guiana human"	"NA"
"BCL"	"Human"	"10. French Guiana human"	"NA"
"BCD"	"Human"	"10. French Guiana human"	"NA"
"BDP"	"Human"	"10. French Guiana human"	"NA"
"BCI"	"Human"	"10. French Guiana human"	"NA"
"BCC"	"Human"	"10. French Guiana human"	"NA"
"BEC"	"Human"	"10. French Guiana human"	"NA"
"BED"	"Human"	"10. French Guiana human"	"NA"
"BCE"	"Human"	"10. French Guiana human"	"NA"
"BCQ"	"Human"	"10. French Guiana human"	"NA"
"BDV"	"Human"	"10. French Guiana human"	"NA"
"BNB"	"Fruit"	"10. French Guiana human"	"NA"
"BDR"	"Human"	"10. French Guiana human"	"NA"
"BMV"	"Nature"	"10. French Guiana human"	"NA"
"BNA"	"Nature"	"10. French Guiana human"	"NA"
"BCH"	"Human"	"10. French Guiana human"	"NA"
"BCP"	"Human"	"10. French Guiana human"	"NA"
"BDS"	"Human"	"10. French Guiana human"	"NA"
"BCN"	"Human"	"10. French Guiana human"	"NA"
"BEA"	"Human"	"10. French Guiana human"	"NA"
"BNC"	"Fruit"	"10. French Guiana human"	"NA"
"BDQ"	"Human"	"10. French Guiana human"	"NA"
"BEB"	"Human"	"10. French Guiana human"	"NA"
"BCK"	"Human"	"10. French Guiana human"	"NA"
"BMR"	"Nature"	"10. French Guiana human"	"NA"
"BEE"	"Human"	"10. French Guiana human"	"NA"
"BND"	"Fruit"	"10. French Guiana human"	"NA"
"CQS"	"Nature"	NA	"NA"
"BBM"	"Distillery"	NA	"NA"
"CPA"	"Nature"	NA	"NA"
"ADE"	"Palm wine"	NA	"NA"
"SACE_YCL"	"Tree"	NA	"NA"
"SACE_YBV"	"Human, clinical"	NA	"NA"
"SACE_YAX"	"Human, clinical"	NA	"NA"
"SACE_YCG"	"Industrial"	NA	"NA"
"AAH"	"Unknown"	NA	"NA"
"AFS"	"Fruit"	NA	"NA"
"AGC"	"Distillery"	NA	"NA"
"CFC"	"Beer"	"11. Ale beer"	"Domesticated"
"AGB"	"Beer"	"11. Ale beer"	"Domesticated"
"ATV"	"Beer"	"11. Ale beer"	"Domesticated"
"AAC"	"Beer"	"11. Ale beer"	"Domesticated"
"CBR"	"Beer"	"11. Ale beer"	"Domesticated"
"CFG"	"Beer"	"11. Ale beer"	"Domesticated"
"CFH"	"Beer"	"11. Ale beer"	"Domesticated"
"AEC"	"Beer"	"11. Ale beer"	"Domesticated"
"CFD"	"Beer"	"11. Ale beer"	"Domesticated"
"CFM"	"Beer"	"11. Ale beer"	"Domesticated"
"AQT"	"Beer"	"11. Ale beer"	"Domesticated"
"BRP"	"Beer"	"11. Ale beer"	"Domesticated"
"BSI"	"Beer"	"11. Ale beer"	"Domesticated"
"AEB"	"Beer"	"11. Ale beer"	"Domesticated"
"ASH"	"Beer"	"11. Ale beer"	"Domesticated"
"BBG"	"Water"	"11. Ale beer"	"Domesticated"
"BRQ"	"Beer"	"11. Ale beer"	"Domesticated"
"CGC"	"Fruit"	"11. Ale beer"	"Domesticated"
"CNC"	"Bioethanol"	"M3. Mosaic region 3"	"NA"
"BMQ"	"Human, clinical"	"M3. Mosaic region 3"	"NA"
"ACN"	"Wine"	"M3. Mosaic region 3"	"NA"
"CBK"	"Insect"	"M3. Mosaic region 3"	"NA"
"CBL"	"Insect"	"M3. Mosaic region 3"	"NA"
"AKI"	"Wine"	"M3. Mosaic region 3"	"NA"
"ADA"	"Wine"	"M3. Mosaic region 3"	"NA"
"ATE"	"Unknown"	"M3. Mosaic region 3"	"NA"
"CBM"	"Insect"	"M3. Mosaic region 3"	"NA"
"ACA"	"Fruit"	"M3. Mosaic region 3"	"NA"
"ACB"	"Dairy"	"M3. Mosaic region 3"	"NA"
"BRL"	"Unknown"	"M3. Mosaic region 3"	"NA"
"ADT"	"Nature"	"M3. Mosaic region 3"	"NA"
"SACE_GAV"	"Lab strain"	"M3. Mosaic region 3"	"NA"
"SACE_YCE"	"Distillery"	"M3. Mosaic region 3"	"NA"
"SACE_YCH"	"Nature"	"M3. Mosaic region 3"	"NA"
"CLG"	"Human, clinical"	"M3. Mosaic region 3"	"NA"
"CQC"	"Fermentation"	"12. West African cocoa"	"Domesticated"
"CQD"	"Fermentation"	"12. West African cocoa"	"Domesticated"
"CQG"	"Fermentation"	"12. West African cocoa"	"Domesticated"
"CQI"	"Fermentation"	"12. West African cocoa"	"Domesticated"
"CQH"	"Fermentation"	"12. West African cocoa"	"Domesticated"
"CQL"	"Fermentation"	"12. West African cocoa"	"Domesticated"
"ANN"	"Fermentation"	"12. West African cocoa"	"Domesticated"
"CQM"	"Fermentation"	"12. West African cocoa"	"Domesticated"
"CQE"	"Fermentation"	"12. West African cocoa"	"Domesticated"
"CQK"	"Fermentation"	"12. West African cocoa"	"Domesticated"
"CQF"	"Fermentation"	"12. West African cocoa"	"Domesticated"
"CQN"	"Fermentation"	"12. West African cocoa"	"Domesticated"
"CQP"	"Fermentation"	"12. West African cocoa"	"Domesticated"
"AKQ"	"Insect"	"M3. Mosaic region 3"	"NA"
"AKS"	"Flower"	"M3. Mosaic region 3"	"NA"
"ALG"	"Fruit"	"M3. Mosaic region 3"	"NA"
"ABH"	"Human, clinical"	"M3. Mosaic region 3"	"NA"
"SACE_YAN"	"Human, clinical"	"M3. Mosaic region 3"	"NA"
"SACE_YBZ"	"Fruit"	"M3. Mosaic region 3"	"NA"
"BTI"	"Tree"	"M3. Mosaic region 3"	"NA"
"CGB"	"Insect"	"M3. Mosaic region 3"	"NA"
"SACE_YDG"	"Fruit"	"M3. Mosaic region 3"	"NA"
"ABI"	"Human, clinical"	"M3. Mosaic region 3"	"NA"
"SACE_YAT"	"Human, clinical"	"M3. Mosaic region 3"	"NA"
"BSK"	"Unknown"	"M3. Mosaic region 3"	"NA"
"BMD"	"Human"	"M3. Mosaic region 3"	"NA"
"AAV"	"Human, clinical"	"M3. Mosaic region 3"	"NA"
"BRV"	"Human, clinical"	"M3. Mosaic region 3"	"NA"
"SACE_YAP"	"Human, clinical"	"M3. Mosaic region 3"	"NA"
"SACE_YAQ"	"Human, clinical"	"M3. Mosaic region 3"	"NA"
"SACE_YAR"	"Human, clinical"	"M3. Mosaic region 3"	"NA"
"ABK"	"Human, clinical"	"M3. Mosaic region 3"	"NA"
"SACE_YAU"	"Human, clinical"	"M3. Mosaic region 3"	"NA"
"ABA"	"Human, clinical"	"M3. Mosaic region 3"	"NA"
"SACE_YAV"	"Human, clinical"	"M3. Mosaic region 3"	"NA"
"AAS"	"Human, clinical"	"M3. Mosaic region 3"	"NA"
"AAT"	"Human, clinical"	"M3. Mosaic region 3"	"NA"
"ABG"	"Human, clinical"	"M3. Mosaic region 3"	"NA"
"SACE_YAK"	"Human, clinical"	"M3. Mosaic region 3"	"NA"
"CEN"	"Fruit"	"M3. Mosaic region 3"	"NA"
"SACE_YAW"	"Human, clinical"	"M3. Mosaic region 3"	"NA"
"SACE_YBJ"	"Human, clinical"	"M3. Mosaic region 3"	"NA"
"SACE_YBK"	"Human, clinical"	"M3. Mosaic region 3"	"NA"
"SACE_YBL"	"Human, clinical"	"M3. Mosaic region 3"	"NA"
"SACE_YBT"	"Human, clinical"	"M3. Mosaic region 3"	"NA"
"ADK"	"Bakery"	"M3. Mosaic region 3"	"NA"
"SACE_MAB"	"Human, clinical"	"M3. Mosaic region 3"	"NA"
"CKA"	"Human, clinical"	"M3. Mosaic region 3"	"NA"
"AGP"	"Fruit"	"M3. Mosaic region 3"	"NA"
"SACE_YDH"	"Fermentation"	"M3. Mosaic region 3"	"NA"
"CHS"	"Human, clinical"	"M3. Mosaic region 3"	"NA"
"CHT"	"Human, clinical"	"M3. Mosaic region 3"	"NA"
"ABD"	"Human, clinical"	"M3. Mosaic region 3"	"NA"
"ATC"	"Human, clinical"	"M3. Mosaic region 3"	"NA"
"ATD"	"Human, clinical"	"M3. Mosaic region 3"	"NA"
"ANA"	"Wine"	"M3. Mosaic region 3"	"NA"
"BBL"	"Insect"	"M3. Mosaic region 3"	"NA"
"CDC"	"Tree"	"M3. Mosaic region 3"	"NA"
"CDD"	"Tree"	"M3. Mosaic region 3"	"NA"
"CDE"	"Tree"	"M3. Mosaic region 3"	"NA"
"CPC"	"Fruit"	"M3. Mosaic region 3"	"NA"
"BMF"	"Human"	"M3. Mosaic region 3"	"NA"
"CKN"	"Human, clinical"	"M3. Mosaic region 3"	"NA"
"CIG"	"Human, clinical"	"M3. Mosaic region 3"	"NA"
"CIL"	"Human, clinical"	"M3. Mosaic region 3"	"NA"
"AAG"	"Unknown"	"M3. Mosaic region 3"	"NA"
"AHA"	"Fruit"	"M3. Mosaic region 3"	"NA"
"CII"	"Human, clinical"	"M3. Mosaic region 3"	"NA"
"CIK"	"Human, clinical"	"M3. Mosaic region 3"	"NA"
"BTA"	"Human, clinical"	"M3. Mosaic region 3"	"NA"
"BDC"	"Nature"	"M3. Mosaic region 3"	"NA"
"BDF"	"Nature"	"M3. Mosaic region 3"	"NA"
"BDG"	"Nature"	"M3. Mosaic region 3"	"NA"
"CHQ"	"Bakery"	"M3. Mosaic region 3"	"NA"
"ALR"	"Tree"	"M3. Mosaic region 3"	"NA"
"AEL"	"Distillery"	"M3. Mosaic region 3"	"NA"
"AEE"	"Distillery"	"M3. Mosaic region 3"	"NA"
"ARA"	"Distillery"	"M3. Mosaic region 3"	"NA"
"ARB"	"Bakery"	"M3. Mosaic region 3"	"NA"
"BTB"	"Bakery"	"M3. Mosaic region 3"	"NA"
"ATB"	"Nature"	"M3. Mosaic region 3"	"NA"
"BIE"	"Wine"	"M3. Mosaic region 3"	"NA"
"BPA"	"Soil"	"M3. Mosaic region 3"	"NA"
"AGT"	"Unknown"	"M3. Mosaic region 3"	"NA"
"CIH"	"Human, clinical"	"M3. Mosaic region 3"	"NA"
"ABF"	"Human, clinical"	"M3. Mosaic region 3"	"NA"
"SACE_YAL"	"Human, clinical"	"M3. Mosaic region 3"	"NA"
"AEI"	"Bakery"	"M3. Mosaic region 3"	"NA"
"AFG"	"Bakery"	"M3. Mosaic region 3"	"NA"
"SACE_YBU"	"Human, clinical"	"M3. Mosaic region 3"	"NA"
"SACE_YBM"	"Human, clinical"	"M3. Mosaic region 3"	"NA"
"ABC"	"Human, clinical"	"M3. Mosaic region 3"	"NA"
"SACE_YDL"	"Human, clinical"	"M3. Mosaic region 3"	"NA"
"SACE_YDN"	"Human, clinical"	"M3. Mosaic region 3"	"NA"
"CIC"	"Human, clinical"	"M3. Mosaic region 3"	"NA"
"CDK"	"Tree"	"M3. Mosaic region 3"	"NA"
"CEM"	"Fermentation"	"M3. Mosaic region 3"	"NA"
"CIF"	"Human, clinical"	"M3. Mosaic region 3"	"NA"
"CID"	"Human, clinical"	"M3. Mosaic region 3"	"NA"
"BBT"	"Wine"	"M3. Mosaic region 3"	"NA"
"CHN"	"Bakery"	"M3. Mosaic region 3"	"NA"
"CHP"	"Bakery"	"M3. Mosaic region 3"	"NA"
"CMG"	"Sake"	"M3. Mosaic region 3"	"NA"
"CRE"	"Insect"	"M3. Mosaic region 3"	"NA"
"BDM"	"Nature"	"M3. Mosaic region 3"	"NA"
"ACI"	"Fruit"	"M3. Mosaic region 3"	"NA"
"SACE_YCS"	"Unknown"	"M3. Mosaic region 3"	"NA"
"ACL"	"Palm wine"	"M3. Mosaic region 3"	"NA"
"CEQ"	"Fermentation"	"M3. Mosaic region 3"	"NA"
"BAB"	"Palm wine"	"13. African palm wine"	"Domesticated"
"AVV"	"Palm wine"	"13. African palm wine"	"Domesticated"
"BAA"	"Palm wine"	"13. African palm wine"	"Domesticated"
"BAD"	"Palm wine"	"13. African palm wine"	"Domesticated"
"BAC"	"Palm wine"	"13. African palm wine"	"Domesticated"
"BAE"	"Palm wine"	"13. African palm wine"	"Domesticated"
"BAF"	"Palm wine"	"13. African palm wine"	"Domesticated"
"CFA"	"Palm wine"	"13. African palm wine"	"Domesticated"
"SACE_GAL"	"Lab strain"	"13. African palm wine"	"Domesticated"
"CPS"	"Palm wine"	"13. African palm wine"	"Domesticated"
"CPT"	"Palm wine"	"13. African palm wine"	"Domesticated"
"CQA"	"Palm wine"	"13. African palm wine"	"Domesticated"
"CQB"	"Palm wine"	"13. African palm wine"	"Domesticated"
"AHS"	"Wine"	"13. African palm wine"	"Domesticated"
"ADV"	"Palm wine"	"13. African palm wine"	"Domesticated"
"AKG"	"Palm wine"	"13. African palm wine"	"Domesticated"
"SACE_YAC"	"Palm wine"	"13. African palm wine"	"Domesticated"
"ADF"	"Tree"	"13. African palm wine"	"Domesticated"
"AKB"	"Palm wine"	"13. African palm wine"	"Domesticated"
"AKD"	"Palm wine"	"13. African palm wine"	"Domesticated"
"AKC"	"Palm wine"	"13. African palm wine"	"Domesticated"
"AKE"	"Palm wine"	"13. African palm wine"	"Domesticated"
"AKH"	"Palm wine"	"13. African palm wine"	"Domesticated"
"APQ"	"Palm wine"	"13. African palm wine"	"Domesticated"
"APR"	"Beer"	"13. African palm wine"	"Domesticated"
"ATP"	"Palm wine"	"13. African palm wine"	"Domesticated"
"SACE_YBP"	"Wine"	"13. African palm wine"	"Domesticated"
"SACE_YCV"	"Beer"	"13. African palm wine"	"Domesticated"
"BAM"	"Nature"	"14. CHNIII"	"Wild"
"BAQ"	"Tree"	"14. CHNIII"	"Wild"
"BAG"	"Tree"	"15. CHNII"	"Wild"
"BAH"	"Tree"	"15. CHNII"	"Wild"
"BAL"	"Nature"	"16. CHNI"	"Wild"
"AMH"	"Soil"	"17. Taiwanese"	"Wild"
"CEG"	"Soil"	"17. Taiwanese"	"Wild"
"CEI"	"Soil"	"17. Taiwanese"	"Wild"
"CCQ"	"Tree"	"18. Far East Asia"	"Wild"
"CCR"	"Tree"	"18. Far East Asia"	"Wild"
"CCS"	"Tree"	"18. Far East Asia"	"Wild"
"BAK"	"Tree"	"18. Far East Asia"	"Wild"
"BAI"	"Fruit"	"18. Far East Asia"	"Wild"
"ACQ"	"Wine"	"18. Far East Asia"	"Wild"
"CCN"	"Fruit"	"18. Far East Asia"	"Wild"
"CDL"	"Tree"	"18. Far East Asia"	"Wild"
"SACE_YCR"	"Tree"	"18. Far East Asia"	"Wild"
"BMA"	"Tree"	"19. Malaysian"	"Wild"
"AKM"	"Tree"	"19. Malaysian"	"Wild"
"BMB"	"Tree"	"19. Malaysian"	"Wild"
"BMC"	"Tree"	"19. Malaysian"	"Wild"
"SACE_MAL"	"Insect"	"19. Malaysian"	"Wild"
"SACE_YCY"	"Tree"	"19. Malaysian"	"Wild"
"ABL"	"Soil"	NA	"NA"
"SACE_YCB"	"Soil"	NA	"NA"
"AMM"	"Tree"	NA	"NA"
"BAN"	"Nature"	"20. CHN V"	"NA"
"BAP"	"Soil"	"20. CHN V"	"NA"
"CMP"	"Tree"	"21. Ecuadorean"	"Wild"
"CCH"	"Insect"	"21. Ecuadorean"	"Wild"
"ACC"	"Tree"	"21. Ecuadorean"	"Wild"
"CCC"	"Flower"	"21. Ecuadorean"	"Wild"
"CCD"	"Flower"	"21. Ecuadorean"	"Wild"
"CCE"	"Flower"	"21. Ecuadorean"	"Wild"
"CCF"	"Insect"	"21. Ecuadorean"	"Wild"
"CCG"	"Fruit"	"21. Ecuadorean"	"Wild"
"CCI"	"Insect"	"21. Ecuadorean"	"Wild"
"CMQ"	"Tree"	"21. Ecuadorean"	"Wild"
"SACE_GAT"	"Nature"	NA	"NA"
"SACE_YCX"	"Nature"	NA	"NA"
"CDN"	"Insect"	NA	"NA"
"BFA"	"Soil"	NA	"NA"
"BFL"	"Tree"	NA	"NA"
"AMB"	"Insect"	NA	"NA"
"AMC"	"Insect"	NA	"NA"
"CDQ"	"Tree"	NA	"NA"
"SACE_GAS"	"Nature"	NA	"NA"
"SACE_YCW"	"Fruit"	NA	"NA"
"CDF"	"Fruit"	"22. Far East Russian"	"NA"
"CDG"	"Wine"	"22. Far East Russian"	"NA"
"CDH"	"Tree"	"22. Far East Russian"	"NA"
"CDI"	"Tree"	"22. Far East Russian"	"NA"
"AMD"	"Fruit"	NA	"NA"
"AMF"	"Fruit"	NA	"NA"
"CEH"	"Fruit"	NA	"NA"
"CCP"	"Tree"	NA	"NA"
"BEG"	"Industrial"	NA	"NA"
"CDB"	"Soil"	NA	"NA"
"AVI"	"Soil"	"23. North American oak"	"Wild"
"ACD"	"Tree"	"23. North American oak"	"Wild"
"ANF"	"Soil"	"23. North American oak"	"Wild"
"ANH"	"Nature"	"23. North American oak"	"Wild"
"ANC"	"Tree"	"23. North American oak"	"Wild"
"ANE"	"Soil"	"23. North American oak"	"Wild"
"ANG"	"Soil"	"23. North American oak"	"Wild"
"AND"	"Soil"	"23. North American oak"	"Wild"
"ANK"	"Tree"	"23. North American oak"	"Wild"
"ANI"	"Soil"	"23. North American oak"	"Wild"
"AKN"	"Soil"	"23. North American oak"	"Wild"
"SACE_YBS"	"Tree"	"23. North American oak"	"Wild"
"SACE_YCU"	"Tree"	"23. North American oak"	"Wild"
"BBR"	"Tree"	NA	"NA"
"SACE_YCO"	"Wine"	NA	"NA"
"CMS"	"Tree"	NA	"NA"
"ADG"	"Tree"	NA	"NA"
"CDP"	"Tree"	NA	"NA"
"SACE_YDI"	"Unknown"	NA	"NA"
"ARH"	"Fermentation"	"24. Asian islands"	"NA"
"ARI"	"Fermentation"	"24. Asian islands"	"NA"
"AFK"	"Palm wine"	"24. Asian islands"	"NA"
"AHH"	"Palm wine"	"24. Asian islands"	"NA"
"CCT"	"Tree"	"24. Asian islands"	"NA"
"CCV"	"Tree"	"24. Asian islands"	"NA"
"CDA"	"Tree"	"24. Asian islands"	"NA"
"AGR"	"Nature"	"24. Asian islands"	"NA"
"ARG"	"Tree"	"24. Asian islands"	"NA"
"SACE_YCM"	"Fruit"	"24. Asian islands"	"NA"
"SACE_YDE"	"Palm wine"	"24. Asian islands"	"NA"
"SACE_YCN"	"Fruit"	NA	"NA"
"ASM"	"Nature"	NA	"NA"
"CGH"	"Unknown"	NA	"NA"
"CEP"	"Fermentation"	NA	"NA"
"CKR"	"Human, clinical"	NA	"NA"
"ARP"	"Wine"	"25. Sake"	"Domesticated"
"AEF"	"Sake"	"25. Sake"	"Domesticated"
"CMH"	"Sake"	"25. Sake"	"Domesticated"
"ARM"	"Fruit"	"25. Sake"	"Domesticated"
"CLI"	"Sake"	"25. Sake"	"Domesticated"
"CMK"	"Sake"	"25. Sake"	"Domesticated"
"CLQ"	"Sake"	"25. Sake"	"Domesticated"
"CLN"	"Sake"	"25. Sake"	"Domesticated"
"AFN"	"Sake"	"25. Sake"	"Domesticated"
"ADQ"	"Sake"	"25. Sake"	"Domesticated"
"AFM"	"Sake"	"25. Sake"	"Domesticated"
"APA"	"Sake"	"25. Sake"	"Domesticated"
"BTS"	"Sake"	"25. Sake"	"Domesticated"
"ANT"	"Sake"	"25. Sake"	"Domesticated"
"ANR"	"Sake"	"25. Sake"	"Domesticated"
"ANV"	"Sake"	"25. Sake"	"Domesticated"
"ADN"	"Sake"	"25. Sake"	"Domesticated"
"CMF"	"Sake"	"25. Sake"	"Domesticated"
"CMI"	"Sake"	"25. Sake"	"Domesticated"
"AAD"	"Sake"	"25. Sake"	"Domesticated"
"ANS"	"Sake"	"25. Sake"	"Domesticated"
"AQN"	"Sake"	"25. Sake"	"Domesticated"
"CLM"	"Sake"	"25. Sake"	"Domesticated"
"CMN"	"Sake"	"25. Sake"	"Domesticated"
"APC"	"Sake"	"25. Sake"	"Domesticated"
"APD"	"Sake"	"25. Sake"	"Domesticated"
"AVC"	"Sake"	"25. Sake"	"Domesticated"
"CMD"	"Sake"	"25. Sake"	"Domesticated"
"CLP"	"Sake"	"25. Sake"	"Domesticated"
"CMC"	"Sake"	"25. Sake"	"Domesticated"
"APF"	"Sake"	"25. Sake"	"Domesticated"
"APE"	"Sake"	"25. Sake"	"Domesticated"
"AVD"	"Sake"	"25. Sake"	"Domesticated"
"AVM"	"Sake"	"25. Sake"	"Domesticated"
"CLT"	"Sake"	"25. Sake"	"Domesticated"
"CLS"	"Sake"	"25. Sake"	"Domesticated"
"CME"	"Sake"	"25. Sake"	"Domesticated"
"CLL"	"Sake"	"25. Sake"	"Domesticated"
"CLR"	"Sake"	"25. Sake"	"Domesticated"
"CML"	"Sake"	"25. Sake"	"Domesticated"
"CMM"	"Sake"	"25. Sake"	"Domesticated"
"CMB"	"Sake"	"25. Sake"	"Domesticated"
"AVL"	"Sake"	"25. Sake"	"Domesticated"
"CLV"	"Sake"	"25. Sake"	"Domesticated"
"CLK"	"Sake"	"25. Sake"	"Domesticated"
"CQQ"	"Sake"	"25. Sake"	"Domesticated"
"CQR"	"Sake"	"25. Sake"	"Domesticated"
"AHQ"	"Industrial"	"26. Asian fermentation"	"NA"
"CGL"	"Unknown"	"26. Asian fermentation"	"NA"
"AFH"	"Distillery"	"26. Asian fermentation"	"NA"
"AGG"	"Distillery"	"26. Asian fermentation"	"NA"
"AEP"	"Distillery"	"26. Asian fermentation"	"NA"
"CEV"	"Distillery"	"26. Asian fermentation"	"NA"
"CGI"	"Unknown"	"26. Asian fermentation"	"NA"
"CGN"	"Fermentation"	"26. Asian fermentation"	"NA"
"CGP"	"Unknown"	"26. Asian fermentation"	"NA"
"CGG"	"Unknown"	"26. Asian fermentation"	"NA"
"CGR"	"Fermentation"	"26. Asian fermentation"	"NA"
"AQS"	"Distillery"	"26. Asian fermentation"	"NA"
"BEH"	"Fermentation"	"26. Asian fermentation"	"NA"
"ACM"	"Fermentation"	"26. Asian fermentation"	"NA"
"AKL"	"Sake"	"26. Asian fermentation"	"NA"
"ABB"	"Human, clinical"	"26. Asian fermentation"	"NA"
"ACK"	"Palm wine"	"26. Asian fermentation"	"NA"
"ADH"	"Tree"	"26. Asian fermentation"	"NA"
"SACE_YDA"	"Palm wine"	"26. Asian fermentation"	"NA"
"ALB"	"Insect"	"26. Asian fermentation"	"NA"
"AKR"	"Fruit"	"26. Asian fermentation"	"NA"
"ALC"	"Nature"	"26. Asian fermentation"	"NA"
"ALH"	"Nature"	"26. Asian fermentation"	"NA"
"ALA"	"Insect"	"26. Asian fermentation"	"NA"
"ALK"	"Tree"	"26. Asian fermentation"	"NA"
"CGQ"	"Unknown"	"26. Asian fermentation"	"NA"
"BRG"	"Soil"	"26. Asian fermentation"	"NA"
"CGK"	"Unknown"	"26. Asian fermentation"	"NA"
"CHM"	"Bakery"	"26. Asian fermentation"	"NA"
"BHP"	"Fermentation"	"26. Asian fermentation"	"NA"
"BHQ"	"Fermentation"	"26. Asian fermentation"	"NA"
"BHR"	"Fermentation"	"26. Asian fermentation"	"NA"
"BHS"	"Fermentation"	"26. Asian fermentation"	"NA"
"BEF"	"Fermentation"	"26. Asian fermentation"	"NA"
"CEK"	"Fermentation"	"26. Asian fermentation"	"NA"
"CEL"	"Fermentation"	"26. Asian fermentation"	"NA"
"SACE_YCJ"	"Unknown"	"26. Asian fermentation"	"NA"
"SACE_YCK"	"Industrial"	"26. Asian fermentation"	"NA"
"SACE_YDK"	"Industrial"	"26. Asian fermentation"	"NA"
